NO ./files/bluestone.xpm
SO ./files/colorstone.xpm
EA ./files/greystone.xpm
WE ./files/purplestone.xpm

F 12,141,234
C 135,206,2a35

111111
100001
10N001
111111
