NO ./files/bluestone.xpm
SO ./files/colorstone.xpm
WE ./files/greystone.xpm
EA ./files/purplestone.xpm

F 120,120,120
C 135,206,235

111111
100N01
10N001
100001
111111
