F 120,120,120
C 135,206,235

111111
100001
1N0001
111111
