NO ./files/bluestone.xpm
SO ./files/colorstone.xpm
WE ./files/greystone.xpm
EA ./files/purplestone.xpm

F 120,120,120
C 135,206,235

1111111111
11111S1111
1000000001
1000000001
1000000001
1000000001
1000000001
1000000001
1000000001
1000000001
1111111111
