NO ./files/bluestone.xpm
SO ./files/colorstone.xpm
WE ./files/greystone.xpm
EA ./files/purplestone.xpm

F 120,120,120
C 135,206,235

        1111111111111111111111111
        1000000000110000000000001
        1011000001110000000000001
        1001000000000000000000001
111111111011000001110000000000001
100000000011000001110000000011111
11110111111111011100000000001
11110111111111011101010000001
11000000110101011100000000001
10000000000000001101000000001
10000000000000001101010000001
11000001110101011111011110N0111
11110111 1110101 101111010001
11111111 1111111 111111111111
