NO ./files/bluestone.xpm
SO ./files/colorstone.xpm
WE ./files/greystone.xpm
EA ./files/purplestone.xpm

F 120,120,120
C 135,206,235

111111111111111
1N0000010000001
101110111011101
100010001010001
111011101011101
100000100010001
101111101111101
101000100000001
101011101011101
100010001010001
111011101011101
100010001000001
101111111111101
100000000000001
111111111111111
